111111111111111111111111111
1C0000000000000000000000001
100011111111111111111110001
100010000000000000000010001
100010111111111011111010001
1P00000000000000000000000E1
100010111111111111111010001
100010000000000000000010001
100011111111111111111110001
1C0000000000000000000000001
111111111111111111111111111